fitness,benefit,cost,litterSize,numLost,numFixed,numTotal,percentFixed
-1,0.196,0.1,2,1023591,214,1023805,2.0902417940916483e-4
-1,0.196,0.1,4,1023770,40,1023810,3.906974926988406e-5
-1,0.196,0.1,6,1023701,109,1023810,1.0646506676043406e-4
-1,0.196,0.1,8,1023678,132,1023810,1.289301725906174e-4
-1,0.196,0.1,10,1023630,180,1023810,1.7581387171447828e-4
-1,0.197,0.1,2,1023605,198,1023803,1.9339658117821496e-4
-1,0.197,0.1,4,1023660,150,1023810,1.4651155976206523e-4
-1,0.197,0.1,6,1023519,291,1023810,2.8423242593840655e-4
-1,0.197,0.1,8,1023490,320,1023810,3.125579941590725e-4
-1,0.197,0.1,10,1023416,394,1023810,3.84837030308358e-4
-1,0.198,0.1,2,1023602,194,1023796,1.8949087513528087e-4
-1,0.198,0.1,4,1023384,425,1023809,4.151164914549491e-4
-1,0.198,0.1,6,1023228,582,1023810,5.684648518768131e-4
-1,0.198,0.1,8,1023078,732,1023810,7.149764116388783e-4
-1,0.198,0.1,10,1023075,735,1023810,7.179066428341196e-4
-1,0.199,0.1,2,1023607,195,1023802,1.9046651598648957e-4
-1,0.199,0.1,4,1022897,913,1023810,8.917670270851037e-4
-1,0.199,0.1,6,1022681,1129,1023810,0.0011027436731424775
-1,0.199,0.1,8,1022603,1207,1023810,0.0011789296842187515
-1,0.199,0.1,10,1022629,1181,1023810,0.001153534347193327
-1,0.2,0.1,2,1023623,173,1023796,1.6897897628043087e-4
-1,0.2,0.1,4,1022381,1429,1023810,0.001395766792666608
-1,0.2,0.1,6,1022052,1758,1023810,0.0017171154804114044
-1,0.2,0.1,8,1021955,1855,1023810,0.0018118596223908733
-1,0.2,0.1,10,1021888,1922,1023810,0.0018773014524179291
-1,0.201,0.1,2,1023607,195,1023802,1.9046651598648957e-4
-1,0.201,0.1,4,1021606,2204,1023810,0.002152743184770612
-1,0.201,0.1,6,1021291,2519,1023810,0.002460417460270949
-1,0.201,0.1,8,1021104,2706,1023810,0.0026430685381076567
-1,0.201,0.1,10,1021080,2730,1023810,0.002666510387669587
-0.014,0.196,0.1,2,1023807,3,1023810,2.9302311952413045e-6
-0.014,0.196,0.1,4,1023754,56,1023810,5.4697648977837685e-5
-0.014,0.196,0.1,6,1023699,111,1023810,1.0841855422392827e-4
-0.014,0.196,0.1,8,1023659,151,1023810,1.4748830349381234e-4
-0.014,0.196,0.1,10,1023655,155,1023810,1.5139527842080073e-4
-0.014,0.197,0.1,2,1023800,10,1023810,9.767437317471015e-6
-0.014,0.197,0.1,4,1023620,190,1023810,1.855813090319493e-4
-0.014,0.197,0.1,6,1023565,245,1023810,2.3930221427803986e-4
-0.014,0.197,0.1,8,1023485,325,1023810,3.17441712817808e-4
-0.014,0.197,0.1,10,1023443,366,1023809,3.5748855499414444e-4
-0.014,0.198,0.1,2,1023807,3,1023810,2.9302311952413045e-6
-0.014,0.198,0.1,4,1023462,348,1023810,3.399068186479913e-4
-0.014,0.198,0.1,6,1023340,470,1023810,4.5906955392113774e-4
-0.014,0.198,0.1,8,1023213,596,1023809,5.821398327227051e-4
-0.014,0.198,0.1,10,1023119,687,1023806,6.710255653903181e-4
-0.014,0.199,0.1,2,1023805,5,1023810,4.8837186587355076e-6
-0.014,0.199,0.1,4,1023186,624,1023810,6.094880886101914e-4
-0.014,0.199,0.1,6,1022978,832,1023810,8.126507848135884e-4
-0.014,0.199,0.1,8,1022777,1029,1023806,0.0010050732267636643
-0.014,0.199,0.1,10,1022737,1070,1023807,0.0010451188554092715
-0.014,0.2,0.1,2,1023805,5,1023810,4.8837186587355076e-6
-0.014,0.2,0.1,4,1022838,972,1023810,9.493949072581826e-4
-0.014,0.2,0.1,6,1022516,1294,1023810,0.0012639063888807494
-0.014,0.2,0.1,8,1022124,1683,1023807,0.0016438645174334616
-0.014,0.2,0.1,10,1022010,1796,1023806,0.0017542385959840047
-0.014,0.201,0.1,2,1023804,6,1023810,5.860462390482609e-6
-0.014,0.201,0.1,4,1022410,1400,1023810,0.0013674412244459421
-0.014,0.201,0.1,6,1021852,1954,1023806,0.0019085647085482992
-0.014,0.201,0.1,8,1021554,2250,1023804,0.0021976862758887445
-0.014,0.201,0.1,10,1021231,2577,1023808,0.0025170735137838344
-0.012,0.196,0.1,2,1023804,6,1023810,5.860462390482609e-6
-0.012,0.196,0.1,4,1023749,61,1023810,5.958136763657319e-5
-0.012,0.196,0.1,6,1023704,106,1023810,1.0353483556519276e-4
-0.012,0.196,0.1,8,1023680,130,1023810,1.269766851271232e-4
-0.012,0.196,0.1,10,1023628,182,1023810,1.7776735917797247e-4
-0.012,0.197,0.1,2,1023806,4,1023810,3.906974926988406e-6
-0.012,0.197,0.1,4,1023646,164,1023810,1.6018597200652464e-4
-0.012,0.197,0.1,6,1023562,248,1023810,2.4223244547328117e-4
-0.012,0.197,0.1,8,1023462,348,1023810,3.399068186479913e-4
-0.012,0.197,0.1,10,1023468,342,1023810,3.3404635625750874e-4
-0.012,0.198,0.1,2,1023808,2,1023810,1.953487463494203e-6
-0.012,0.198,0.1,4,1023524,286,1023810,2.7934870727967104e-4
-0.012,0.198,0.1,6,1023338,472,1023810,4.610230413846319e-4
-0.012,0.198,0.1,8,1023168,641,1023809,6.26093343582641e-4
-0.012,0.198,0.1,10,1023133,677,1023810,6.612555063927878e-4
-0.012,0.199,0.1,2,1023807,3,1023810,2.9302311952413045e-6
-0.012,0.199,0.1,4,1023248,562,1023810,5.489299772418711e-4
-0.012,0.199,0.1,6,1022982,828,1023810,8.087438098866001e-4
-0.012,0.199,0.1,8,1022771,1037,1023808,0.0010128852284803402
-0.012,0.199,0.1,10,1022636,1173,1023809,0.0011457215164156595
-0.012,0.2,0.1,2,1023806,4,1023810,3.906974926988406e-6
-0.012,0.2,0.1,4,1022972,838,1023810,8.185112472040711e-4
-0.012,0.2,0.1,6,1022506,1304,1023810,0.0012736738261982204
-0.012,0.2,0.1,8,1022207,1602,1023809,0.001564744986613714
-0.012,0.2,0.1,10,1021985,1824,1023809,0.0017815823068560639
-0.012,0.201,0.1,2,1023801,9,1023810,8.790693585723913e-6
-0.012,0.201,0.1,4,1022539,1271,1023810,0.001241441283050566
-0.012,0.201,0.1,6,1021873,1935,1023808,0.0018900028130274427
-0.012,0.201,0.1,8,1021527,2282,1023809,0.002228931372941633
-0.012,0.201,0.1,10,1021320,2488,1023808,0.00243014315184097
-0.01,0.196,0.1,2,1023807,3,1023810,2.9302311952413045e-6
-0.01,0.196,0.1,4,1023749,61,1023810,5.958136763657319e-5
-0.01,0.196,0.1,6,1023706,104,1023810,1.0158134810169855e-4
-0.01,0.196,0.1,8,1023673,137,1023810,1.338138912493529e-4
-0.01,0.196,0.1,10,1023648,162,1023810,1.5823248454303044e-4
-0.01,0.197,0.1,2,1023809,1,1023810,9.767437317471015e-7
-0.01,0.197,0.1,4,1023682,128,1023810,1.25023197663629e-4
-0.01,0.197,0.1,6,1023582,228,1023810,2.2269757083833913e-4
-0.01,0.197,0.1,8,1023496,314,1023810,3.0669753176858986e-4
-0.01,0.197,0.1,10,1023443,367,1023810,3.5846494955118623e-4
-0.01,0.198,0.1,2,1023803,7,1023810,6.837206122229711e-6
-0.01,0.198,0.1,4,1023552,258,1023810,2.519998827907522e-4
-0.01,0.198,0.1,6,1023335,475,1023810,4.6395327257987325e-4
-0.01,0.198,0.1,8,1023206,604,1023810,5.899532139752494e-4
-0.01,0.198,0.1,10,1023121,688,1023809,6.720003438141294e-4
-0.01,0.199,0.1,2,1023806,4,1023810,3.906974926988406e-6
-0.01,0.199,0.1,4,1023297,513,1023810,5.01069534386263e-4
-0.01,0.199,0.1,6,1023023,786,1023809,7.677213230202118e-4
-0.01,0.199,0.1,8,1022772,1038,1023810,0.0010138599935534914
-0.01,0.199,0.1,10,1022667,1142,1023809,0.0011154424311565928
-0.01,0.2,0.1,2,1023802,8,1023810,7.813949853976812e-6
-0.01,0.2,0.1,4,1022950,860,1023810,8.399996093025073e-4
-0.01,0.2,0.1,6,1022481,1328,1023809,0.001297116942710994
-0.01,0.2,0.1,8,1022221,1587,1023808,0.0015500953303744453
-0.01,0.2,0.1,10,1022055,1754,1023809,0.0017132101788517194
-0.01,0.201,0.1,2,1023806,4,1023810,3.906974926988406e-6
-0.01,0.201,0.1,4,1022598,1212,1023810,0.001183813402877487
-0.01,0.201,0.1,6,1021853,1954,1023807,0.001908562844364221
-0.01,0.201,0.1,8,1021355,2454,1023809,0.002396931458895165
-0.01,0.201,0.1,10,1021237,2573,1023810,0.0025131616217852924
-0.008,0.196,0.1,2,1023804,6,1023810,5.860462390482609e-6
-0.008,0.196,0.1,4,1023755,55,1023810,5.3720905246090586e-5
-0.008,0.196,0.1,6,1023699,111,1023810,1.0841855422392827e-4
-0.008,0.196,0.1,8,1023640,169,1023809,1.650698518962033e-4
-0.008,0.196,0.1,10,1023651,159,1023810,1.5530225334778913e-4
-0.008,0.197,0.1,2,1023808,2,1023810,1.953487463494203e-6
-0.008,0.197,0.1,4,1023693,117,1023810,1.1427901661441088e-4
-0.008,0.197,0.1,6,1023580,230,1023810,2.2465105830183336e-4
-0.008,0.197,0.1,8,1023494,316,1023810,3.086510192320841e-4
-0.008,0.197,0.1,10,1023464,346,1023810,3.3795333118449714e-4
-0.008,0.198,0.1,2,1023802,8,1023810,7.813949853976812e-6
-0.008,0.198,0.1,4,1023553,257,1023810,2.510231390590051e-4
-0.008,0.198,0.1,6,1023327,483,1023810,4.7176722243385004e-4
-0.008,0.198,0.1,8,1023195,615,1023810,6.006973950244674e-4
-0.008,0.198,0.1,10,1023142,668,1023810,6.524648128070638e-4
-0.008,0.199,0.1,2,1023805,5,1023810,4.8837186587355076e-6
-0.008,0.199,0.1,4,1023342,468,1023810,4.571160664576435e-4
-0.008,0.199,0.1,6,1022985,825,1023810,8.058135786913588e-4
-0.008,0.199,0.1,8,1022719,1091,1023810,0.0010656274113360878
-0.008,0.199,0.1,10,1022698,1112,1023810,0.001086139029702777
-0.008,0.2,0.1,2,1023804,6,1023810,5.860462390482609e-6
-0.008,0.2,0.1,4,1023012,798,1023810,7.79441497934187e-4
-0.008,0.2,0.1,6,1022416,1393,1023809,0.0013606053472864567
-0.008,0.2,0.1,8,1022145,1665,1023810,0.001626278313358924
-0.008,0.2,0.1,10,1022069,1741,1023810,0.0017005108369717037
-0.008,0.201,0.1,2,1023803,7,1023810,6.837206122229711e-6
-0.008,0.201,0.1,4,1022564,1246,1023810,0.0012170226897568884
-0.008,0.201,0.1,6,1021801,2008,1023809,0.0019613033290389126
-0.008,0.201,0.1,8,1021369,2440,1023809,0.0023832570332942963
-0.008,0.201,0.1,10,1021266,2544,1023810,0.002484836053564626
-0.006,0.196,0.1,2,1014605,5,1014610,4.928001892352726e-6
-0.006,0.196,0.1,4,1014561,49,1014610,4.829441854505672e-5
-0.006,0.196,0.1,6,1014502,108,1014610,1.064448408748189e-4
-0.006,0.196,0.1,8,1014471,130,1014601,1.2812918575873667e-4
-0.006,0.196,0.1,10,1014422,178,1014600,1.7543859649122806e-4
-0.006,0.197,0.1,2,1014593,7,1014600,6.899270648531441e-6
-0.006,0.197,0.1,4,1014485,115,1014600,1.133451606544451e-4
-0.006,0.197,0.1,6,1014363,237,1014600,2.3358959195742164e-4
-0.006,0.197,0.1,8,1014266,334,1014600,3.291937709442145e-4
-0.006,0.197,0.1,10,1014220,373,1014593,3.676351009715226e-4
-0.006,0.198,0.1,2,1014583,7,1014590,6.899338649109493e-6
-0.006,0.198,0.1,4,1014359,231,1014590,2.2767817542061324e-4
-0.006,0.198,0.1,6,1014134,456,1014590,4.4944263199913264e-4
-0.006,0.198,0.1,8,1013934,656,1014590,6.46566593402261e-4
-0.006,0.198,0.1,10,1013953,637,1014590,6.278398170689639e-4
-0.006,0.199,0.1,2,1014587,3,1014590,2.9568594210469253e-6
-0.006,0.199,0.1,4,1014131,459,1014590,4.523994914201796e-4
-0.006,0.199,0.1,6,1013752,838,1014590,8.259493982791078e-4
-0.006,0.199,0.1,8,1013466,1120,1014586,0.0011038985359545666
-0.006,0.199,0.1,10,1013357,1217,1014574,0.0011995182214407229
-0.006,0.2,0.1,2,1014566,4,1014570,3.9425569453068785e-6
-0.006,0.2,0.1,4,1013777,793,1014570,7.816119144070888e-4
-0.006,0.2,0.1,6,1013221,1349,1014570,0.0013296273298047448
-0.006,0.2,0.1,8,1012851,1718,1014569,0.0016933298770216714
-0.006,0.2,0.1,10,1012701,1869,1014570,0.001842159732694639
-0.006,0.201,0.1,2,1014564,6,1014570,5.913835417960318e-6
-0.006,0.201,0.1,4,1013325,1245,1014570,0.0012271208492267661
-0.006,0.201,0.1,6,1012398,2168,1014566,0.002136874289104898
-0.006,0.201,0.1,8,1012091,2469,1014560,0.0024335672606844347
-0.006,0.201,0.1,10,1011896,2664,1014560,0.00262576880618199
0,0.196,0.1,2,999993,7,1000000,7e-6
0,0.196,0.1,4,999954,46,1000000,4.6e-5
0,0.196,0.1,6,999909,91,1000000,9.1e-5
0,0.196,0.1,8,999851,149,1000000,1.49e-4
0,0.196,0.1,10,999833,167,1000000,1.67e-4
0,0.197,0.1,2,999990,10,1000000,1e-5
0,0.197,0.1,4,999813,187,1000000,1.87e-4
0,0.197,0.1,6,999728,272,1000000,2.72e-4
0,0.197,0.1,8,999640,360,1000000,3.6e-4
0,0.197,0.1,10,999619,381,1000000,3.81e-4
0,0.198,0.1,2,1000054,6,1000060,5.999640021598704e-6
0,0.198,0.1,4,999622,438,1000060,4.3797372157670537e-4
0,0.198,0.1,6,999483,575,1000058,5.749666519341878e-4
0,0.198,0.1,8,999428,622,1000050,6.219689015549223e-4
0,0.198,0.1,10,999307,743,1000050,7.429628518574071e-4
0,0.199,0.1,2,1000035,7,1000042,6.999706012347481e-6
0,0.199,0.1,4,999217,823,1000040,8.229670813167474e-4
0,0.199,0.1,6,998952,1088,1000040,0.0010879564817407304
0,0.199,0.1,8,998861,1179,1000040,0.0011789528418863246
0,0.199,0.1,10,998833,1203,1000036,0.0012029566935590319
0,0.2,0.1,2,1000017,9,1000026,8.999766006083841e-6
0,0.2,0.1,4,998583,1437,1000020,0.0014369712605747885
0,0.2,0.1,6,998287,1733,1000020,0.001732965340693186
0,0.2,0.1,8,998188,1832,1000020,0.0018319633607327853
0,0.2,0.1,10,998070,1946,1000016,0.001945968864498168
0,0.201,0.1,2,1000007,3,1000010,2.999970000299997e-6
0,0.201,0.1,4,997884,2126,1000010,0.002125978740212598
0,0.201,0.1,6,997620,2390,1000010,0.0023899761002389975
0,0.201,0.1,8,997383,2624,1000007,0.0026239816321285752
0,0.201,0.1,10,997340,2660,1000000,0.00266
