fitness,benefit,cost,litterSize,numLost,numFixed,numTotal,percentFixed
-1,0.195,0.1,2,1005412,203,1005615,2.0186651949304654e-4
-1,0.195,0.1,4,999277,3,999280,3.002161556320551e-6
-1,0.195,0.1,6,1010259,1,1010260,9.898441985231524e-7
-1,0.195,0.1,8,684735,5,684740,7.302041650845577e-6
-1,0.195,0.1,10,995595,5,995600,5.02209722780233e-6
-1,0.196,0.1,2,1005416,202,1005618,2.0087150389113957e-4
-1,0.196,0.1,4,999266,14,999280,1.4010087262829237e-5
-1,0.196,0.1,6,1010249,11,1010260,1.0888286183754678e-5
-1,0.196,0.1,8,684727,13,684740,1.8985308292198497e-5
-1,0.196,0.1,10,995590,9,995599,9.039784089779118e-6
-1,0.197,0.1,2,1005441,180,1005621,1.7899387542622916e-4
-1,0.197,0.1,4,749251,29,749280,3.870382233610933e-5
-1,0.197,0.1,6,1010228,32,1010260,3.1675014352740876e-5
-1,0.197,0.1,8,684725,15,684740,2.1906124952536728e-5
-1,0.197,0.1,10,995568,22,995590,2.209744975341255e-5
-1,0.198,0.1,2,1005436,184,1005620,1.829716990513315e-4
-1,0.198,0.1,4,999202,78,999280,7.805620046433433e-5
-1,0.198,0.1,6,1010192,66,1010258,6.532984643526703e-5
-1,0.198,0.1,8,684705,35,684740,5.1114291555919034e-5
-1,0.198,0.1,10,995544,46,995590,4.620375857531715e-5
-1,0.199,0.1,2,1005431,189,1005620,1.8794375609076987e-4
-1,0.199,0.1,4,999099,181,999280,1.8113041389800658e-4
-1,0.199,0.1,6,1010109,141,1010250,1.3956941351150705e-4
-1,0.199,0.1,8,684665,75,684740,1.0953062476268365e-4
-1,0.199,0.1,10,995499,91,995590,9.140308761638827e-5
-1,0.2,0.1,2,1005417,207,1005624,2.0584234266485287e-4
-1,0.2,0.1,4,998917,350,999267,3.502567381890926e-4
-1,0.2,0.1,6,1009996,254,1010250,2.514229151200198e-4
-1,0.2,0.1,8,684600,140,684740,2.0445716622367614e-4
-1,0.2,0.1,10,995432,158,995590,1.5869986641087194e-4
-1,0.201,0.1,2,1014973,209,1015182,2.0587441463698134e-4
-1,0.201,0.1,4,1008171,658,1008829,6.522413610235233e-4
-1,0.201,0.1,6,1019338,472,1019810,4.628313117149273e-4
-1,0.201,0.1,8,694070,222,694292,3.197501915620517e-4
-1,0.201,0.1,10,1004902,248,1005150,2.46729343879023e-4
-0.014,0.195,0.1,2,1005622,8,1005630,7.955212155564173e-6
-0.014,0.195,0.1,4,749255,15,749270,2.0019485632682477e-5
-0.014,0.195,0.1,6,1010228,22,1010250,2.1776787923781243e-5
-0.014,0.195,0.1,8,684716,14,684730,2.044601521767704e-5
-0.014,0.195,0.1,10,995571,19,995590,1.9084161150674475e-5
-0.014,0.196,0.1,2,1005622,8,1005630,7.955212155564173e-6
-0.014,0.196,0.1,4,999228,42,999270,4.203068239815065e-5
-0.014,0.196,0.1,6,1010217,33,1010250,3.266518188567186e-5
-0.014,0.196,0.1,8,684710,20,684730,2.9208593168110057e-5
-0.014,0.196,0.1,10,995565,25,995590,2.5110738356150623e-5
-0.014,0.197,0.1,2,1005621,9,1005630,8.949613675009696e-6
-0.014,0.197,0.1,4,999222,48,999270,4.803506559788646e-5
-0.014,0.197,0.1,6,1010206,44,1010250,4.3553575847562486e-5
-0.014,0.197,0.1,8,684698,32,684730,4.673374906897609e-5
-0.014,0.197,0.1,10,995545,45,995590,4.519932904107112e-5
-0.014,0.198,0.1,2,1005622,8,1005630,7.955212155564173e-6
-0.014,0.198,0.1,4,999164,106,999270,1.0607743652866592e-4
-0.014,0.198,0.1,6,1010162,88,1010250,8.710715169512497e-5
-0.014,0.198,0.1,8,684685,45,684730,6.571933462824764e-5
-0.014,0.198,0.1,10,995516,74,995590,7.432778553420585e-5
-0.014,0.199,0.1,2,1005623,7,1005630,6.960810636118652e-6
-0.014,0.199,0.1,4,999088,178,999266,1.7813074796900924e-4
-0.014,0.199,0.1,6,1010120,130,1010250,1.2868101954961644e-4
-0.014,0.199,0.1,8,684668,62,684730,9.054663882114118e-5
-0.014,0.199,0.1,10,995512,78,995590,7.834550367118994e-5
-0.014,0.2,0.1,2,1005624,4,1005628,3.977613988472875e-6
-0.014,0.2,0.1,4,998998,262,999260,2.6219402357744733e-4
-0.014,0.2,0.1,6,1010069,181,1010250,1.7916357337292748e-4
-0.014,0.2,0.1,8,684644,86,684730,1.2559695062287326e-4
-0.014,0.2,0.1,10,995473,117,995590,1.1751825550678493e-4
-0.014,0.201,0.1,2,1015175,5,1015180,4.925234933706338e-6
-0.014,0.201,0.1,4,1008438,382,1008820,3.786602168870562e-4
-0.014,0.201,0.1,6,1019542,268,1019810,2.62794049872035e-4
-0.014,0.201,0.1,8,694166,124,694290,1.7859972057785651e-4
-0.014,0.201,0.1,10,1005001,149,1005150,1.482365816047356e-4
-0.012,0.195,0.1,2,1005613,7,1005620,6.960879855213699e-6
-0.012,0.195,0.1,4,999223,27,999250,2.7020265198899176e-5
-0.012,0.195,0.1,6,1010225,20,1010245,1.9797177912288604e-5
-0.012,0.195,0.1,8,684712,13,684725,1.898572419584505e-5
-0.012,0.195,0.1,10,995559,31,995590,3.113731556162677e-5
-0.012,0.196,0.1,2,1005614,6,1005620,5.966468447326028e-6
-0.012,0.196,0.1,4,999206,44,999250,4.4033024768576435e-5
-0.012,0.196,0.1,6,1010203,37,1010240,3.662496040544821e-5
-0.012,0.196,0.1,8,684697,23,684720,3.359037270709195e-5
-0.012,0.196,0.1,10,995561,29,995590,2.9128456493134725e-5
-0.012,0.197,0.1,2,1005616,4,1005620,3.977645631550685e-6
-0.012,0.197,0.1,4,999188,62,999250,6.204653490117588e-5
-0.012,0.197,0.1,6,1010178,62,1010240,6.13715552739943e-5
-0.012,0.197,0.1,8,684686,34,684720,4.965533356700549e-5
-0.012,0.197,0.1,10,995547,43,995590,4.3190469972579074e-5
-0.012,0.198,0.1,2,1005613,7,1005620,6.960879855213699e-6
-0.012,0.198,0.1,4,999148,102,999250,1.0207655741806355e-4
-0.012,0.198,0.1,6,1010154,86,1010240,8.512828634779854e-5
-0.012,0.198,0.1,8,684666,48,684714,7.010226167421726e-5
-0.012,0.198,0.1,10,995540,50,995590,5.0221476712301245e-5
-0.012,0.199,0.1,2,1005615,5,1005620,4.972057039438356e-6
-0.012,0.199,0.1,4,999075,175,999250,1.7513134851138354e-4
-0.012,0.199,0.1,6,1010126,114,1010240,1.1284447260057016e-4
-0.012,0.199,0.1,8,684634,76,684710,1.1099589607278993e-4
-0.012,0.199,0.1,10,995514,76,995590,7.63366446026979e-5
-0.012,0.2,0.1,2,1005614,6,1005620,5.966468447326028e-6
-0.012,0.2,0.1,4,998999,246,999245,2.461858703321007e-4
-0.012,0.2,0.1,6,1010045,195,1010240,1.930234399746595e-4
-0.012,0.2,0.1,8,684612,98,684710,1.4312628704122912e-4
-0.012,0.2,0.1,10,995483,107,995590,1.0747396016432467e-4
-0.012,0.201,0.1,2,1015172,6,1015178,5.910293564281338e-6
-0.012,0.201,0.1,4,1008458,342,1008800,3.390166534496431e-4
-0.012,0.201,0.1,6,1019575,225,1019800,2.2063149637183762e-4
-0.012,0.201,0.1,8,694147,123,694270,1.7716450372333531e-4
-0.012,0.201,0.1,10,1004990,160,1005150,1.591802218574342e-4
-0.01,0.195,0.1,2,1005605,5,1005610,4.972106482632432e-6
-0.01,0.195,0.1,4,999204,36,999240,3.6027380809415156e-5
-0.01,0.195,0.1,6,1010193,47,1010240,4.6523598352866646e-5
-0.01,0.195,0.1,8,684695,15,684710,2.1907084751208542e-5
-0.01,0.195,0.1,10,995572,18,995590,1.8079731616428448e-5
-0.01,0.196,0.1,2,1005602,8,1005610,7.955370372211891e-6
-0.01,0.196,0.1,4,999187,53,999240,5.3040310636083425e-5
-0.01,0.196,0.1,6,1010198,42,1010240,4.157427937915743e-5
-0.01,0.196,0.1,8,684683,27,684710,3.943275255217537e-5
-0.01,0.196,0.1,10,995552,38,995590,3.816832230134895e-5
-0.01,0.197,0.1,2,1005605,5,1005610,4.972106482632432e-6
-0.01,0.197,0.1,4,999147,93,999240,9.307073375765582e-5
-0.01,0.197,0.1,6,1010160,80,1010240,7.918910357934748e-5
-0.01,0.197,0.1,8,684678,28,684706,4.089346376400966e-5
-0.01,0.197,0.1,10,995544,46,995590,4.620375857531715e-5
-0.01,0.198,0.1,2,1005603,7,1005610,6.960949075685405e-6
-0.01,0.198,0.1,4,999145,95,999240,9.507225491373444e-5
-0.01,0.198,0.1,6,1010152,87,1010239,8.611823538786366e-5
-0.01,0.198,0.1,8,684644,56,684700,8.178764422374763e-5
-0.01,0.198,0.1,10,995527,63,995590,6.327906065749957e-5
-0.01,0.199,0.1,2,1005602,8,1005610,7.955370372211891e-6
-0.01,0.199,0.1,4,999069,165,999234,0.00016512648688895695
-0.01,0.199,0.1,6,1010107,118,1010225,1.1680566210497662e-4
-0.01,0.199,0.1,8,684646,54,684700,7.886665693004236e-5
-0.01,0.199,0.1,10,995512,78,995590,7.834550367118994e-5
-0.01,0.2,0.1,2,1005604,6,1005610,5.966527779158918e-6
-0.01,0.2,0.1,4,999006,224,999230,2.241726129119422e-4
-0.01,0.2,0.1,6,1010066,154,1010220,1.5244204232741382e-4
-0.01,0.2,0.1,8,684601,99,684700,1.44588871038411e-4
-0.01,0.2,0.1,10,995474,116,995590,1.165138259725389e-4
-0.01,0.201,0.1,2,1015167,3,1015170,2.9551700700375305e-6
-0.01,0.201,0.1,4,1008460,330,1008790,3.2712457498587416e-4
-0.01,0.201,0.1,6,1019541,239,1019780,0.00023436427464747298
-0.01,0.201,0.1,8,694135,125,694260,1.8004782070117823e-4
-0.01,0.201,0.1,10,1005000,141,1005141,1.402788265526926e-4
-0.008,0.195,0.1,2,1005606,4,1005610,3.9776851861059455e-6
-0.008,0.195,0.1,4,999200,30,999230,3.0023117800706544e-5
-0.008,0.195,0.1,6,1010199,21,1010220,2.0787551226465524e-5
-0.008,0.195,0.1,8,684682,18,684700,2.628888564334745e-5
-0.008,0.195,0.1,10,995561,19,995580,1.9084352839550816e-5
-0.008,0.196,0.1,2,1005597,6,1005603,5.966569312144057e-6
-0.008,0.196,0.1,4,999176,52,999228,5.2040175015111666e-5
-0.008,0.196,0.1,6,1010174,46,1010220,4.5534636019876856e-5
-0.008,0.196,0.1,8,684673,27,684700,3.943332846502118e-5
-0.008,0.196,0.1,10,995539,41,995580,4.118202454850439e-5
-0.008,0.197,0.1,2,1005592,8,1005600,7.955449482895783e-6
-0.008,0.197,0.1,4,999139,81,999220,8.106322931886872e-5
-0.008,0.197,0.1,6,1010161,59,1010220,5.840312011245075e-5
-0.008,0.197,0.1,8,684666,34,684700,4.965678399298963e-5
-0.008,0.197,0.1,10,995543,37,995580,3.7164266055967376e-5
-0.008,0.198,0.1,2,1005598,2,1005600,1.9888623707239457e-6
-0.008,0.198,0.1,4,999078,136,999214,1.3610698008634787e-4
-0.008,0.198,0.1,6,1010135,85,1010220,8.414008829759854e-5
-0.008,0.198,0.1,8,684641,59,684700,8.616912516430554e-5
-0.008,0.198,0.1,10,995515,65,995580,6.528857550372648e-5
-0.008,0.199,0.1,2,1005597,3,1005600,2.983293556085919e-6
-0.008,0.199,0.1,4,999070,140,999210,1.4011068744308004e-4
-0.008,0.199,0.1,6,1010112,108,1010220,1.0690740630753697e-4
-0.008,0.199,0.1,8,684634,59,684693,8.617000611953094e-5
-0.008,0.199,0.1,10,995495,85,995580,8.537736796641154e-5
-0.008,0.2,0.1,2,1005595,5,1005600,4.972155926809865e-6
-0.008,0.2,0.1,4,999006,204,999210,2.0416128741705948e-4
-0.008,0.2,0.1,6,1010045,175,1010220,1.7322959355387936e-4
-0.008,0.2,0.1,8,684600,90,684690,1.3144634798229856e-4
-0.008,0.2,0.1,10,995469,111,995580,1.1149279816790213e-4
-0.008,0.201,0.1,2,1015157,3,1015160,2.9551991804247604e-6
-0.008,0.201,0.1,4,1008476,294,1008770,2.914440358059815e-4
-0.008,0.201,0.1,6,1019541,239,1019780,0.00023436427464747298
-0.008,0.201,0.1,8,694140,109,694249,1.5700418725846202e-4
-0.008,0.201,0.1,10,1004996,144,1005140,1.432636249676662e-4
-0.006,0.195,0.1,2,1005593,7,1005600,6.961018297533811e-6
-0.006,0.195,0.1,4,999175,35,999210,3.502767186077001e-5
-0.006,0.195,0.1,6,1010182,38,1010220,3.761556888598523e-5
-0.006,0.195,0.1,8,684658,22,684680,3.213179879651808e-5
-0.006,0.195,0.1,10,995557,23,995580,2.310211133208783e-5
-0.006,0.196,0.1,2,1005594,6,1005600,5.966587112171838e-6
-0.006,0.196,0.1,4,999149,61,999210,6.104822810019916e-5
-0.006,0.196,0.1,6,1010172,48,1010220,4.751440280334976e-5
-0.006,0.196,0.1,8,684655,25,684680,3.6513407723316e-5
-0.006,0.196,0.1,10,995550,26,995576,2.6115535127403635e-5
-0.006,0.197,0.1,2,1005596,4,1005600,3.9777247414478914e-6
-0.006,0.197,0.1,4,999126,84,999210,8.406641246584802e-5
-0.006,0.197,0.1,6,1010144,70,1010214,6.929224896903033e-5
-0.006,0.197,0.1,8,684641,39,684680,5.696091604837296e-5
-0.006,0.197,0.1,10,995529,41,995570,4.118243820123146e-5
-0.006,0.198,0.1,2,1005592,8,1005600,7.955449482895783e-6
-0.006,0.198,0.1,4,999094,116,999210,1.1609171245283774e-4
-0.006,0.198,0.1,6,1010119,91,1010210,9.008028033775155e-5
-0.006,0.198,0.1,8,684625,55,684680,8.03294969912952e-5
-0.006,0.198,0.1,10,995496,74,995570,7.432927870466166e-5
-0.006,0.199,0.1,2,1005594,6,1005600,5.966587112171838e-6
-0.006,0.199,0.1,4,999055,155,999210,1.5512254681198146e-4
-0.006,0.199,0.1,6,1010115,95,1010210,9.403985309985053e-5
-0.006,0.199,0.1,8,684621,59,684680,8.617164222702576e-5
-0.006,0.199,0.1,10,995481,89,995570,8.939602438803902e-5
-0.006,0.2,0.1,2,1005593,7,1005600,6.961018297533811e-6
-0.006,0.2,0.1,4,998989,221,999210,2.2117472803514777e-4
-0.006,0.2,0.1,6,1010057,153,1010210,1.514536581502856e-4
-0.006,0.2,0.1,8,684598,82,684680,1.1976397733247649e-4
-0.006,0.2,0.1,10,995472,98,995570,9.843607179806544e-5
-0.006,0.201,0.1,2,1015152,4,1015156,3.940281099653649e-6
-0.006,0.201,0.1,4,1008457,313,1008770,3.1027885444650415e-4
-0.006,0.201,0.1,6,1019552,218,1019770,2.137736940682703e-4
-0.006,0.201,0.1,8,694130,110,694240,1.5844664669278636e-4
-0.006,0.201,0.1,10,1004996,134,1005130,1.3331608846616855e-4
0,0.195,0.1,2,1005667,3,1005670,2.9830859029303846e-6
0,0.195,0.1,4,999286,4,999290,4.002842017832661e-6
0,0.195,0.1,6,1010287,3,1010290,2.969444416949589e-6
0,0.195,0.1,8,684754,4,684758,5.8414797636537284e-6
0,0.195,0.1,10,995633,5,995638,5.021905552017902e-6
0,0.196,0.1,2,1005657,10,1005667,9.943649339194782e-6
0,0.196,0.1,4,999282,8,999290,8.005684035665322e-6
0,0.196,0.1,6,1010281,9,1010290,8.908333250848766e-6
0,0.196,0.1,8,684743,7,684750,1.0222709017889742e-5
0,0.196,0.1,10,995620,10,995630,1.0043891807197453e-5
0,0.197,0.1,2,1005657,3,1005660,2.983115565897023e-6
0,0.197,0.1,4,999268,22,999290,2.2015631098079637e-5
0,0.197,0.1,6,1010266,24,1010290,2.375555533559671e-5
0,0.197,0.1,8,684730,11,684741,1.606446817117713e-5
0,0.197,0.1,10,995607,23,995630,2.3100951156554142e-5
0,0.198,0.1,2,1005657,3,1005660,2.983115565897023e-6
0,0.198,0.1,4,999222,67,999289,6.704767089400564e-5
0,0.198,0.1,6,1010220,70,1010290,6.92870363954904e-5
0,0.198,0.1,8,684701,39,684740,5.6955924876595495e-5
0,0.198,0.1,10,995586,35,995621,3.51539390993159e-5
0,0.199,0.1,2,1005633,8,1005641,7.95512513909039e-6
0,0.199,0.1,4,999124,165,999289,1.6511739847031238e-4
0,0.199,0.1,6,1010153,134,1010287,1.3263557781105766e-4
0,0.199,0.1,8,684676,64,684740,9.346613313082338e-5
0,0.199,0.1,10,995529,91,995620,9.140033346055723e-5
0,0.2,0.1,2,1005630,10,1005640,9.943916312000319e-6
0,0.2,0.1,4,998891,397,999288,3.9728286540016494e-4
0,0.2,0.1,6,1009978,297,1010275,2.9397936205488606e-4
0,0.2,0.1,8,684616,124,684740,1.810906329409703e-4
0,0.2,0.1,10,995451,161,995612,1.6170958164425498e-4
0,0.201,0.1,2,1015183,7,1015190,6.895260985628306e-6
0,0.201,0.1,4,1008189,648,1008837,6.423237847144782e-4
0,0.201,0.1,6,1019363,456,1019819,4.4713816863580695e-4
0,0.201,0.1,8,694090,210,694300,3.0246291228575543e-4
0,0.201,0.1,10,1004905,258,1005163,2.5667478806919874e-4
